6
%%%%%%
%....%
%%%.%%
%%..%%
%%.%%%
%%%%%%