10
%%%%%%%%%%
%.%%%%%%.%
%..%%%%..%
%%......%%
%%%%%%%%%%