39
============..===........==..====.....
============..====.......==..======...
=====.........=====......==..==...==..
=====.........==.===.....==..==....==.
==========....==..===....==..==.....==
==========....==...===...==..==.....==
=====.........==....===..==..==....==.
=====.........==.....===.==..==...==..
============..==......=====..=====....
============..==.......====..====.....